"filename", "language", "Java", "comment", "blank", "total"
"c:\Users\hasan\cse496\meetmeout-ws\meetmeout-ws\src\main\java\com\hasandel01\meetmeoutws\ChatController.java", "Java", 20, 0, 9, 29
"c:\Users\hasan\cse496\meetmeout-ws\meetmeout-ws\src\main\java\com\hasandel01\meetmeoutws\ChatMessageRepository.java", "Java", 10, 0, 5, 15
"c:\Users\hasan\cse496\meetmeout-ws\meetmeout-ws\src\main\java\com\hasandel01\meetmeoutws\FriendRequest.java", "Java", 32, 0, 12, 44
"c:\Users\hasan\cse496\meetmeout-ws\meetmeout-ws\src\main\java\com\hasandel01\meetmeoutws\FriendRequestRepository.java", "Java", 22, 0, 5, 27
"c:\Users\hasan\cse496\meetmeout-ws\meetmeout-ws\src\main\java\com\hasandel01\meetmeoutws\Invite.java", "Java", 26, 0, 9, 35
"c:\Users\hasan\cse496\meetmeout-ws\meetmeout-ws\src\main\java\com\hasandel01\meetmeoutws\MeetmeoutWsApplication.java", "Java", 9, 0, 5, 14
"c:\Users\hasan\cse496\meetmeout-ws\meetmeout-ws\src\main\java\com\hasandel01\meetmeoutws\auth\JwtService.java", "Java", 11, 0, 8, 19
"c:\Users\hasan\cse496\meetmeout-ws\meetmeout-ws\src\main\java\com\hasandel01\meetmeoutws\auth\JwtServiceImpl.java", "Java", 54, 0, 19, 73
"c:\Users\hasan\cse496\meetmeout-ws\meetmeout-ws\src\main\java\com\hasandel01\meetmeoutws\config\CorsConfig.java", "Java", 23, 0, 5, 28
"c:\Users\hasan\cse496\meetmeout-ws\meetmeout-ws\src\main\java\com\hasandel01\meetmeoutws\config\WebSocketConfig.java", "Java", 49, 0, 10, 59
"c:\Users\hasan\cse496\meetmeout-ws\meetmeout-ws\src\main\java\com\hasandel01\meetmeoutws\config\WebSocketCookieController.java", "Java", 39, 0, 10, 49
"c:\Users\hasan\cse496\meetmeout-ws\meetmeout-ws\src\main\java\com\hasandel01\meetmeoutws\config\WebSocketSecurityInterceptor.java", "Java", 58, 1, 15, 74
"c:\Users\hasan\cse496\meetmeout-ws\meetmeout-ws\src\main\java\com\hasandel01\meetmeoutws\event\Event.java", "Java", 43, 0, 14, 57
"c:\Users\hasan\cse496\meetmeout-ws\meetmeout-ws\src\main\java\com\hasandel01\meetmeoutws\event\EventChatMessage.java", "Java", 27, 0, 11, 38
"c:\Users\hasan\cse496\meetmeout-ws\meetmeout-ws\src\main\java\com\hasandel01\meetmeoutws\event\EventChatMessageDTO.java", "Java", 7, 0, 7, 14
"c:\Users\hasan\cse496\meetmeout-ws\meetmeout-ws\src\main\java\com\hasandel01\meetmeoutws\event\EventChatMessageMapper.java", "Java", 11, 0, 7, 18
"c:\Users\hasan\cse496\meetmeout-ws\meetmeout-ws\src\main\java\com\hasandel01\meetmeoutws\event\EventChatMessageRepository.java", "Java", 8, 0, 4, 12
"c:\Users\hasan\cse496\meetmeout-ws\meetmeout-ws\src\main\java\com\hasandel01\meetmeoutws\event\EventChatService.java", "Java", 4, 0, 2, 6
"c:\Users\hasan\cse496\meetmeout-ws\meetmeout-ws\src\main\java\com\hasandel01\meetmeoutws\event\EventChatServiceImpl.java", "Java", 34, 0, 14, 48
"c:\Users\hasan\cse496\meetmeout-ws\meetmeout-ws\src\main\java\com\hasandel01\meetmeoutws\event\EventRepository.java", "Java", 6, 0, 4, 10
"c:\Users\hasan\cse496\meetmeout-ws\meetmeout-ws\src\main\java\com\hasandel01\meetmeoutws\notification\NotificationType.java", "Java", 15, 0, 2, 17
"c:\Users\hasan\cse496\meetmeout-ws\meetmeout-ws\src\main\java\com\hasandel01\meetmeoutws\notification\controller\NotificationController.java", "Java", 19, 0, 7, 26
"c:\Users\hasan\cse496\meetmeout-ws\meetmeout-ws\src\main\java\com\hasandel01\meetmeoutws\notification\dto\NotificationDTO.java", "Java", 16, 0, 4, 20
"c:\Users\hasan\cse496\meetmeout-ws\meetmeout-ws\src\main\java\com\hasandel01\meetmeoutws\notification\mapper\NotificationMapper.java", "Java", 29, 0, 7, 36
"c:\Users\hasan\cse496\meetmeout-ws\meetmeout-ws\src\main\java\com\hasandel01\meetmeoutws\notification\model\Notification.java", "Java", 32, 0, 15, 47
"c:\Users\hasan\cse496\meetmeout-ws\meetmeout-ws\src\main\java\com\hasandel01\meetmeoutws\notification\repository\NotificationRepository.java", "Java", 7, 0, 3, 10
"c:\Users\hasan\cse496\meetmeout-ws\meetmeout-ws\src\main\java\com\hasandel01\meetmeoutws\notification\service\NotificationService.java", "Java", 19, 0, 8, 27
"c:\Users\hasan\cse496\meetmeout-ws\meetmeout-ws\src\main\java\com\hasandel01\meetmeoutws\relay\RelayController.java", "Java", 24, 0, 6, 30
"c:\Users\hasan\cse496\meetmeout-ws\meetmeout-ws\src\main\java\com\hasandel01\meetmeoutws\user\BadgeDTO.java", "Java", 12, 0, 4, 16
"c:\Users\hasan\cse496\meetmeout-ws\meetmeout-ws\src\main\java\com\hasandel01\meetmeoutws\user\User.java", "Java", 49, 0, 22, 71
"c:\Users\hasan\cse496\meetmeout-ws\meetmeout-ws\src\main\java\com\hasandel01\meetmeoutws\user\UserDTO.java", "Java", 21, 0, 4, 25
"c:\Users\hasan\cse496\meetmeout-ws\meetmeout-ws\src\main\java\com\hasandel01\meetmeoutws\user\UserMapper.java", "Java", 48, 0, 12, 60
"c:\Users\hasan\cse496\meetmeout-ws\meetmeout-ws\src\main\java\com\hasandel01\meetmeoutws\user\UserRepository.java", "Java", 6, 0, 6, 12
"c:\Users\hasan\cse496\meetmeout-ws\meetmeout-ws\src\main\java\com\hasandel01\meetmeoutws\user\UserReviewDTO.java", "Java", 14, 0, 5, 19
"Total", "-", 804, 1, 280, 1085