"filename", "language", "TypeScript", "TypeScript JSX", "PostCSS", "comment", "blank", "total"
"c:\Users\hasan\cse496\meetmeout-web\src\App.css", "PostCSS", 0, 0, 189, 5, 49, 243
"c:\Users\hasan\cse496\meetmeout-web\src\App.tsx", "TypeScript JSX", 0, 136, 0, 0, 6, 142
"c:\Users\hasan\cse496\meetmeout-web\src\auth\ForgotPassword.tsx", "TypeScript JSX", 0, 39, 0, 0, 5, 44
"c:\Users\hasan\cse496\meetmeout-web\src\auth\Login.tsx", "TypeScript JSX", 0, 60, 0, 0, 7, 67
"c:\Users\hasan\cse496\meetmeout-web\src\auth\Register.tsx", "TypeScript JSX", 0, 66, 0, 0, 14, 80
"c:\Users\hasan\cse496\meetmeout-web\src\auth\ResetPassword.tsx", "TypeScript JSX", 0, 55, 0, 0, 15, 70
"c:\Users\hasan\cse496\meetmeout-web\src\auth\UserDetailsForm.tsx", "TypeScript JSX", 0, 143, 0, 0, 22, 165
"c:\Users\hasan\cse496\meetmeout-web\src\auth\VerifyEmail.tsx", "TypeScript JSX", 0, 35, 0, 0, 12, 47
"c:\Users\hasan\cse496\meetmeout-web\src\auth\axios\authAxios.ts", "TypeScript", 9, 0, 0, 0, 3, 12
"c:\Users\hasan\cse496\meetmeout-web\src\auth\common\Form.module.css", "PostCSS", 0, 0, 171, 0, 38, 209
"c:\Users\hasan\cse496\meetmeout-web\src\auth\common\FormInput.tsx", "TypeScript JSX", 0, 27, 0, 0, 4, 31
"c:\Users\hasan\cse496\meetmeout-web\src\auth\common\ProtectedRoute.tsx", "TypeScript JSX", 0, 12, 0, 0, 8, 20
"c:\Users\hasan\cse496\meetmeout-web\src\axios\axios.ts", "TypeScript", 40, 0, 0, 0, 12, 52
"c:\Users\hasan\cse496\meetmeout-web\src\components\MainFeed\EventCard\EventCard.module.css", "PostCSS", 0, 0, 351, 3, 61, 415
"c:\Users\hasan\cse496\meetmeout-web\src\components\MainFeed\EventCard\EventCard.tsx", "TypeScript JSX", 0, 307, 0, 0, 35, 342
"c:\Users\hasan\cse496\meetmeout-web\src\components\MainFeed\EventFilterPanel\FilterPanel.module.css", "PostCSS", 0, 0, 147, 0, 25, 172
"c:\Users\hasan\cse496\meetmeout-web\src\components\MainFeed\EventFilterPanel\FilterPanel.tsx", "TypeScript JSX", 0, 96, 0, 0, 9, 105
"c:\Users\hasan\cse496\meetmeout-web\src\components\MainFeed\EventRatingStars\EventRatingStars.tsx", "TypeScript JSX", 0, 37, 0, 0, 7, 44
"c:\Users\hasan\cse496\meetmeout-web\src\components\MainFeed\MainFeed.module.css", "PostCSS", 0, 0, 71, 1, 18, 90
"c:\Users\hasan\cse496\meetmeout-web\src\components\MainFeed\MainFeed.tsx", "TypeScript JSX", 0, 254, 0, 0, 58, 312
"c:\Users\hasan\cse496\meetmeout-web\src\components\MainFeed\MainFeedMap\MainFeedMap.module.css", "PostCSS", 0, 0, 138, 0, 23, 161
"c:\Users\hasan\cse496\meetmeout-web\src\components\MainFeed\MainFeedMap\MainFeedMap.tsx", "TypeScript JSX", 0, 221, 0, 0, 62, 283
"c:\Users\hasan\cse496\meetmeout-web\src\components\MainFeed\MainFeedMap\MainFeedMapPanner\MainFeedMapPanner.tsx", "TypeScript JSX", 0, 13, 0, 0, 5, 18
"c:\Users\hasan\cse496\meetmeout-web\src\components\MainLayout\Footer.tsx", "TypeScript JSX", 0, 8, 0, 0, 3, 11
"c:\Users\hasan\cse496\meetmeout-web\src\components\MainLayout\Header\Header.module.css", "PostCSS", 0, 0, 253, 4, 47, 304
"c:\Users\hasan\cse496\meetmeout-web\src\components\MainLayout\Header\Header.tsx", "TypeScript JSX", 0, 279, 0, 0, 40, 319
"c:\Users\hasan\cse496\meetmeout-web\src\components\MainLayout\Header\SearchBox\SearchBox.module.css", "PostCSS", 0, 0, 175, 1, 35, 211
"c:\Users\hasan\cse496\meetmeout-web\src\components\MainLayout\Header\SearchBox\SearchBox.tsx", "TypeScript JSX", 0, 116, 0, 0, 15, 131
"c:\Users\hasan\cse496\meetmeout-web\src\components\MainLayout\MainLayout.module.css", "PostCSS", 0, 0, 34, 0, 6, 40
"c:\Users\hasan\cse496\meetmeout-web\src\components\MainLayout\MainLayout.tsx", "TypeScript JSX", 0, 16, 0, 0, 3, 19
"c:\Users\hasan\cse496\meetmeout-web\src\components\MainLayout\hooks\useMediaQuery.tsx", "TypeScript JSX", 0, 13, 0, 0, 10, 23
"c:\Users\hasan\cse496\meetmeout-web\src\components\ScrollToTop.tsx", "TypeScript JSX", 0, 13, 0, 0, 5, 18
"c:\Users\hasan\cse496\meetmeout-web\src\context\BadgeContext.tsx", "TypeScript JSX", 0, 77, 0, 0, 13, 90
"c:\Users\hasan\cse496\meetmeout-web\src\context\DarkModeContex.tsx", "TypeScript JSX", 0, 33, 0, 0, 25, 58
"c:\Users\hasan\cse496\meetmeout-web\src\context\LocationContex.tsx", "TypeScript JSX", 0, 41, 0, 0, 12, 53
"c:\Users\hasan\cse496\meetmeout-web\src\context\NotificationContext.tsx", "TypeScript JSX", 0, 61, 0, 0, 17, 78
"c:\Users\hasan\cse496\meetmeout-web\src\context\ProfileContext.tsx", "TypeScript JSX", 0, 29, 0, 0, 11, 40
"c:\Users\hasan\cse496\meetmeout-web\src\context\UserContext.tsx", "TypeScript JSX", 0, 40, 0, 0, 11, 51
"c:\Users\hasan\cse496\meetmeout-web\src\context\WebSocketContext.tsx", "TypeScript JSX", 0, 107, 0, 1, 27, 135
"c:\Users\hasan\cse496\meetmeout-web\src\features\calendar\MyCalendar.module.css", "PostCSS", 0, 0, 98, 0, 20, 118
"c:\Users\hasan\cse496\meetmeout-web\src\features\calendar\MyCalendar.tsx", "TypeScript JSX", 0, 147, 0, 0, 19, 166
"c:\Users\hasan\cse496\meetmeout-web\src\features\event\CreateEvent\CreateEvent.module.css", "PostCSS", 0, 0, 923, 12, 180, 1115
"c:\Users\hasan\cse496\meetmeout-web\src\features\event\CreateEvent\CreateEventForm.tsx", "TypeScript JSX", 0, 689, 0, 0, 80, 769
"c:\Users\hasan\cse496\meetmeout-web\src\features\event\CreateEvent\TagInput.tsx", "TypeScript JSX", 0, 92, 0, 0, 10, 102
"c:\Users\hasan\cse496\meetmeout-web\src\features\event\EventDetails\AttendeeContainerModal\AttendeeContainerModal.module.css", "PostCSS", 0, 0, 63, 0, 9, 72
"c:\Users\hasan\cse496\meetmeout-web\src\features\event\EventDetails\AttendeeContainerModal\AttendeeContainerModal.tsx", "TypeScript JSX", 0, 51, 0, 0, 8, 59
"c:\Users\hasan\cse496\meetmeout-web\src\features\event\EventDetails\CompanionsContainerModal\CompanionContainerModal.tsx", "TypeScript JSX", 0, 103, 0, 0, 13, 116
"c:\Users\hasan\cse496\meetmeout-web\src\features\event\EventDetails\CompanionsContainerModal\CompanionsContainerModal.module.css", "PostCSS", 0, 0, 86, 0, 17, 103
"c:\Users\hasan\cse496\meetmeout-web\src\features\event\EventDetails\EventDetails.module.css", "PostCSS", 0, 0, 98, 1, 24, 123
"c:\Users\hasan\cse496\meetmeout-web\src\features\event\EventDetails\EventDetails.tsx", "TypeScript JSX", 0, 447, 0, 0, 81, 528
"c:\Users\hasan\cse496\meetmeout-web\src\features\event\EventDetails\EventHeader\EventHeader.module.css", "PostCSS", 0, 0, 181, 0, 32, 213
"c:\Users\hasan\cse496\meetmeout-web\src\features\event\EventDetails\EventHeader\EventHeader.tsx", "TypeScript JSX", 0, 285, 0, 0, 37, 322
"c:\Users\hasan\cse496\meetmeout-web\src\features\event\EventDetails\EventParticipants\EventParticipants.module.css", "PostCSS", 0, 0, 125, 0, 22, 147
"c:\Users\hasan\cse496\meetmeout-web\src\features\event\EventDetails\EventParticipants\EventParticipants.tsx", "TypeScript JSX", 0, 109, 0, 0, 10, 119
"c:\Users\hasan\cse496\meetmeout-web\src\features\event\EventDetails\FirstTab\Chat\Chat.module.css", "PostCSS", 0, 0, 179, 0, 33, 212
"c:\Users\hasan\cse496\meetmeout-web\src\features\event\EventDetails\FirstTab\Chat\Chat.tsx", "TypeScript JSX", 0, 132, 0, 0, 23, 155
"c:\Users\hasan\cse496\meetmeout-web\src\features\event\EventDetails\FirstTab\EventCard\EventCardDetails.module.css", "PostCSS", 0, 0, 479, 9, 109, 597
"c:\Users\hasan\cse496\meetmeout-web\src\features\event\EventDetails\FirstTab\EventCard\EventPrivacy\EventPrivacy.module.css", "PostCSS", 0, 0, 84, 2, 15, 101
"c:\Users\hasan\cse496\meetmeout-web\src\features\event\EventDetails\FirstTab\EventCard\EventPrivacy\EventPrivacy.tsx", "TypeScript JSX", 0, 82, 0, 0, 17, 99
"c:\Users\hasan\cse496\meetmeout-web\src\features\event\EventDetails\FirstTab\EventCard\EvetCard.tsx", "TypeScript JSX", 0, 391, 0, 0, 43, 434
"c:\Users\hasan\cse496\meetmeout-web\src\features\event\EventDetails\FirstTab\EventComments\EventComments.module.css", "PostCSS", 0, 0, 188, 0, 40, 228
"c:\Users\hasan\cse496\meetmeout-web\src\features\event\EventDetails\FirstTab\EventComments\EventComments.tsx", "TypeScript JSX", 0, 185, 0, 0, 30, 215
"c:\Users\hasan\cse496\meetmeout-web\src\features\event\EventDetails\RequesterContainerModal\RequesterContainerModal.module.css", "PostCSS", 0, 0, 69, 0, 13, 82
"c:\Users\hasan\cse496\meetmeout-web\src\features\event\EventDetails\RequesterContainerModal\RequesterContainerModal.tsx", "TypeScript JSX", 0, 54, 0, 0, 11, 65
"c:\Users\hasan\cse496\meetmeout-web\src\features\event\EventDetails\ReviewModal\ReviewModal.module.css", "PostCSS", 0, 0, 51, 0, 8, 59
"c:\Users\hasan\cse496\meetmeout-web\src\features\event\EventDetails\ReviewModal\ReviewModal.tsx", "TypeScript JSX", 0, 121, 0, 0, 24, 145
"c:\Users\hasan\cse496\meetmeout-web\src\features\event\EventDetails\ReviewModals\ReviewWizardModal.module.css", "PostCSS", 0, 0, 0, 0, 1, 1
"c:\Users\hasan\cse496\meetmeout-web\src\features\event\EventDetails\ReviewModals\ReviewWizardModal.tsx", "TypeScript JSX", 0, 57, 0, 0, 8, 65
"c:\Users\hasan\cse496\meetmeout-web\src\features\event\EventDetails\SecondTab\EventPhotos\EventPhotos.module.css", "PostCSS", 0, 0, 153, 0, 33, 186
"c:\Users\hasan\cse496\meetmeout-web\src\features\event\EventDetails\SecondTab\EventPhotos\EventPhotos.tsx", "TypeScript JSX", 0, 81, 0, 0, 10, 91
"c:\Users\hasan\cse496\meetmeout-web\src\features\event\EventDetails\SecondTab\EventReviews\EventReviews.module.css", "PostCSS", 0, 0, 191, 1, 36, 228
"c:\Users\hasan\cse496\meetmeout-web\src\features\event\EventDetails\SecondTab\EventReviews\EventReviews.tsx", "TypeScript JSX", 0, 191, 0, 0, 25, 216
"c:\Users\hasan\cse496\meetmeout-web\src\features\event\EventDetails\ThirdTab\Car\CarAssignmentBoard.module.css", "PostCSS", 0, 0, 186, 1, 29, 216
"c:\Users\hasan\cse496\meetmeout-web\src\features\event\EventDetails\ThirdTab\Car\CarAssignmentBoard.tsx", "TypeScript JSX", 0, 248, 0, 0, 35, 283
"c:\Users\hasan\cse496\meetmeout-web\src\features\event\EventDetails\ThirdTab\Car\EventCars.module.css", "PostCSS", 0, 0, 65, 0, 11, 76
"c:\Users\hasan\cse496\meetmeout-web\src\features\event\EventDetails\ThirdTab\Car\EventCars.tsx", "TypeScript JSX", 0, 80, 0, 0, 13, 93
"c:\Users\hasan\cse496\meetmeout-web\src\features\event\EventDetails\ThirdTab\Car\PendingCarRequests.module.css", "PostCSS", 0, 0, 51, 0, 7, 58
"c:\Users\hasan\cse496\meetmeout-web\src\features\event\EventDetails\ThirdTab\Car\PendingCarRequests.tsx", "TypeScript JSX", 0, 64, 0, 0, 14, 78
"c:\Users\hasan\cse496\meetmeout-web\src\features\event\EventDetails\ThirdTab\Route\EventRoute.module.css", "PostCSS", 0, 0, 18, 0, 5, 23
"c:\Users\hasan\cse496\meetmeout-web\src\features\event\EventDetails\ThirdTab\Route\EventRoute.tsx", "TypeScript JSX", 0, 79, 0, 0, 10, 89
"c:\Users\hasan\cse496\meetmeout-web\src\features\event\EventDetails\UserRevivewModal\UserReviewModal.module.css", "PostCSS", 0, 0, 93, 0, 15, 108
"c:\Users\hasan\cse496\meetmeout-web\src\features\event\EventDetails\UserRevivewModal\UserReviewModal.tsx", "TypeScript JSX", 0, 77, 0, 0, 17, 94
"c:\Users\hasan\cse496\meetmeout-web\src\features\notifications\Notifications.module.css", "PostCSS", 0, 0, 98, 0, 21, 119
"c:\Users\hasan\cse496\meetmeout-web\src\features\notifications\Notifications.tsx", "TypeScript JSX", 0, 63, 0, 0, 8, 71
"c:\Users\hasan\cse496\meetmeout-web\src\features\user\Settings\Settings.module.css", "PostCSS", 0, 0, 117, 0, 19, 136
"c:\Users\hasan\cse496\meetmeout-web\src\features\user\Settings\Settings.tsx", "TypeScript JSX", 0, 109, 0, 0, 18, 127
"c:\Users\hasan\cse496\meetmeout-web\src\features\user\UserCompanions\UserCompanions.module.css", "PostCSS", 0, 0, 180, 0, 37, 217
"c:\Users\hasan\cse496\meetmeout-web\src\features\user\UserCompanions\UserCompanions.tsx", "TypeScript JSX", 0, 300, 0, 0, 51, 351
"c:\Users\hasan\cse496\meetmeout-web\src\features\user\UserProfile\CarContainer\CarContainer.module.css", "PostCSS", 0, 0, 109, 0, 18, 127
"c:\Users\hasan\cse496\meetmeout-web\src\features\user\UserProfile\CarContainer\CarContainer.tsx", "TypeScript JSX", 0, 135, 0, 0, 22, 157
"c:\Users\hasan\cse496\meetmeout-web\src\features\user\UserProfile\UserProfile.module.css", "PostCSS", 0, 0, 572, 3, 114, 689
"c:\Users\hasan\cse496\meetmeout-web\src\features\user\UserProfile\UserProfile.tsx", "TypeScript JSX", 0, 666, 0, 0, 97, 763
"c:\Users\hasan\cse496\meetmeout-web\src\features\user\UserUpdateForm\UserUpdateForm.module.css", "PostCSS", 0, 0, 96, 0, 25, 121
"c:\Users\hasan\cse496\meetmeout-web\src\features\user\UserUpdateForm\UserUpdateForm.tsx", "TypeScript JSX", 0, 142, 0, 0, 35, 177
"c:\Users\hasan\cse496\meetmeout-web\src\index.css", "PostCSS", 0, 0, 61, 0, 8, 69
"c:\Users\hasan\cse496\meetmeout-web\src\main.tsx", "TypeScript JSX", 0, 9, 0, 0, 2, 11
"c:\Users\hasan\cse496\meetmeout-web\src\map\EventLocationSelector\EventLocationSelector.module.css", "PostCSS", 0, 0, 123, 0, 26, 149
"c:\Users\hasan\cse496\meetmeout-web\src\map\EventLocationSelector\EventLocationSelector.tsx", "TypeScript JSX", 0, 307, 0, 0, 42, 349
"c:\Users\hasan\cse496\meetmeout-web\src\map\FixMap.tsx", "TypeScript JSX", 0, 12, 0, 0, 5, 17
"c:\Users\hasan\cse496\meetmeout-web\src\map\MapPanner.tsx", "TypeScript JSX", 0, 18, 0, 0, 6, 24
"c:\Users\hasan\cse496\meetmeout-web\src\map\RouteDrawer.tsx", "TypeScript JSX", 0, 64, 0, 0, 19, 83
"c:\Users\hasan\cse496\meetmeout-web\src\mapper\CategoryMap.ts", "TypeScript", 31, 0, 0, 0, 4, 35
"c:\Users\hasan\cse496\meetmeout-web\src\types\Badge.ts", "TypeScript", 7, 0, 0, 0, 0, 7
"c:\Users\hasan\cse496\meetmeout-web\src\types\Car.ts", "TypeScript", 20, 0, 0, 0, 5, 25
"c:\Users\hasan\cse496\meetmeout-web\src\types\Event.ts", "TypeScript", 39, 0, 0, 0, 2, 41
"c:\Users\hasan\cse496\meetmeout-web\src\types\EventPhotos.ts", "TypeScript", 6, 0, 0, 0, 0, 6
"c:\Users\hasan\cse496\meetmeout-web\src\types\Forecast.ts", "TypeScript", 56, 0, 0, 0, 7, 63
"c:\Users\hasan\cse496\meetmeout-web\src\types\FriendRequest.ts", "TypeScript", 7, 0, 0, 0, 1, 8
"c:\Users\hasan\cse496\meetmeout-web\src\types\JoinRequest.ts", "TypeScript", 5, 0, 0, 0, 1, 6
"c:\Users\hasan\cse496\meetmeout-web\src\types\Like.ts", "TypeScript", 36, 0, 0, 0, 10, 46
"c:\Users\hasan\cse496\meetmeout-web\src\types\Message.ts", "TypeScript", 6, 0, 0, 0, 1, 7
"c:\Users\hasan\cse496\meetmeout-web\src\types\Notification.ts", "TypeScript", 12, 0, 0, 0, 1, 13
"c:\Users\hasan\cse496\meetmeout-web\src\types\NotificationType.ts", "TypeScript", 12, 0, 0, 0, 0, 12
"c:\Users\hasan\cse496\meetmeout-web\src\types\RecommendedFriend.ts", "TypeScript", 7, 0, 0, 0, 2, 9
"c:\Users\hasan\cse496\meetmeout-web\src\types\RouteType.ts", "TypeScript", 12, 0, 0, 0, 2, 14
"c:\Users\hasan\cse496\meetmeout-web\src\types\TravelAssociate.ts", "TypeScript", 5, 0, 0, 0, 1, 6
"c:\Users\hasan\cse496\meetmeout-web\src\types\User.ts", "TypeScript", 24, 0, 0, 0, 2, 26
"c:\Users\hasan\cse496\meetmeout-web\src\types\UserReviews.ts", "TypeScript", 11, 0, 0, 0, 1, 12
"c:\Users\hasan\cse496\meetmeout-web\src\utils\calculateDistance.ts", "TypeScript", 26, 0, 0, 0, 7, 33
"c:\Users\hasan\cse496\meetmeout-web\src\utils\formatTime.tsx", "TypeScript JSX", 0, 27, 0, 0, 8, 35
"c:\Users\hasan\cse496\meetmeout-web\src\utils\getOrganizerRatingDescription.ts", "TypeScript", 32, 0, 0, 0, 6, 38
"c:\Users\hasan\cse496\meetmeout-web\src\vite-env.d.ts", "TypeScript", 0, 0, 0, 1, 1, 2
"Total", "-", 403, 7951, 6266, 45, 2610, 17275